{
  "schemaVersion": 1,
  "tileSize": 24,
  "width": 50,
  "height": 32,
  "legend": {
    "0": "floor_0",
    "1": "floor_1",
    "2": "floor_2",
    "W": "wall"
  },
  "spawn": {
    "player": {
      "x": 3,
      "y": 3,
      "facing": "down"
    }
  },
  "tiles": [
    "WWWWWWWWWWWWWWWWWWWWWWWWWWWWWWWWWWWWWWWWWWWWWWWWWW",
    "W020100201002010W201002W1002W10020100201002010020W",
    "W000112200000011W200000W1122W00000112200000011220W",
    "W021000210002100W210002W0002W000210002W0002100021W",
    "W202020202020202W20WWWWW02WWW202WW0202W2020202020W",
    "W120001200012000120001200012W001200012W0012000120W",
    "W0000002211000000221100W0002211000WWWWWW100WWWWW2W",
    "W0200102001020010WWW10WWWWWWW01020010200102001020W",
    "W001001200200100W20020010012W02001001200200100120W",
    "W222WWWW22WWW222W22222222222W222222222W2222222222W",
    "W100200210010020W2100100200210010W2002W0010020021W",
    "W020100201002010W2010020100201002W100201002010020W",
    "WWWWWWWWW000WWWWWWW00000112200000W1WWWW000WWWWWWWW",
    "W021000210002100W2100021000210002100021000W100021W",
    "W202020W020202020202WWWW020WWWW20202020202W202020W",
    "W120001WWWW12WWW1200W120001200W12W00120001W000120W",
    "W0000002211000000221W000000221100W00022110W000022W",
    "W020010W00102001020010200102001WWW01WWWWW0W001020W",
    "W001001W0020010012002001001200200W001200200100120W",
    "WWWWWWW2222WWWWWWW222222222222W222222222222222222W",
    "W10020021001W02002W0W100200210W100200210010020021W",
    "W02010020100W01002W1W020100201W02W10WWWWWWW01WWWWW",
    "W00011220000W01122W0WWWWW122WWW00W11220000W01W220W",
    "W02100021000210002W00021000210002W00021000W10W021W",
    "WWWW020WWWWWWW0202W20202020202020W02020202020W020W",
    "W12000120001W00012000120001WWWW12WWWWWW001200W120W",
    "W00WWWWWWWWWW00WWWW11WWW000221100W000221100000022W",
    "W02001020010W00102001020010200102001020010W001020W",
    "W00100120020W10012W0200100120WWWWW001WWWW0W10W120W",
    "W22222222222W22222W22222222222222222222222W22W222W",
    "W10020021001W02002W00100200210010020021001002W021W",
    "WWWWWWWWWWWWWWWWWWWWWWWWWWWWWWWWWWWWWWWWWWWWWWWWWW"
  ]
}